###########################################
###'''''''''''''''''''''''''''''''''''''''#
##''''''''''''''''''''''''''''''''''''''''#
#''''#############################'#'''''##
#'''##''''''#'''''#'''''''''''''##''''''''#
#''##'''''''#'''#'#''''''''''''##'''''''''#
#''#''''#'''''''#'#'''#'''''''##''''''''''#
#''#''''#'''''''#'''''#''''''##'''''''''''#
#''#''#################'''''##''''''''#'''#
#''#''#''''''''''''''''''''##'''''''''#'''#
#''#''#''''''''''''''''''###''''''''''#'''#
#''#''##''#'##############''''''''''''#'###
#''#'''#''''''''''''''''''''''''''##'##'#''
#''''''#''''''''''''''''''''''''''''''''#'#
#''''''#''''''''''''''''''''''''''''''''''#
###########################################