#############################################
#'''''''''#'''''''''''''''''#'''''''''#'''''#
#'''''#'''#'''''#'''''''''''#'''''''''#'''''#
#'''''#'''''''''#'''''''''''''''''#'''''''''#
#'###'#'''''''''''''''''''''''''''#'''####''#
#'''''''''#'''''###'''''''###'''''#'''''''''#
#'''''''''#'''''#'''''''''''#'''''#'''''''''#
###''######'''''''''''''''''''''''''####'####
#'''''''''''''''''''''''''''''''''''''''''''#
#########''''##'''''''''''''''##''''#########
#'''''''''''''''''''''''''''''''''''''''''''#
#''######'''''''#'''''''''''#'''''########''#
#'''''''''''''''###'''''''###'''''#'''''''''#
#'''''''''#'''''''''''''''''''''''#'''''''''#
###''##'''#'''''''''''''''''''''''''''#''####
#'''''#'''#'''''''''''''''''#'''''''''#'''''#
#'''''''''#'''''#'''''''''''#'''''#'''#'''''#
#'''''#'''''''''#'''''''''''''''''#'''''''''#
#############################################
