'''##############################################
''''''''''''''''''#''''''''#'''''#''#'''''''''''#
#'''''####''#''####''####''####''#''#######''####
#'''''#'''''#'''''#''#''''''''#'''''#''#'''''#''#
##########''####''####''##########''#''#''####''#
#''#''''''''#''#'''''''''''#''''''''#''#'''''#''#
#''#''''''''#''#''####''#''#''''''''#''#''#''#''#
#''#''''''''#''''''''#''#''#''''''''''''''#''#''#
#''#''''''''#''#######''####''''''''#######''#''#
#''#''''''''''''''#'''''#''#'''''''''''#''#'''''#
#''#''#######''####''####''####''#''#''#''#''####
#'''''''''''#'''''#'''''''''''#''#'''''#'''''#''#
#''##########''####''##########''#######''####''#
#''#''''''''#''#''#'''''''''''''''''#'''''#'''''#
####''''''''#''#''####''''''''####''#'''''#''#''#
#'''''''''''#''#'''''#''#'''''#''#''#'''''#''#''#
####''#'''''#''####''#''#######''####''####''####
#'''''#''''''''''''''#''#'''''''''''''''''''''''#
#''####''#''#''#''####''#''##########''#''####''#
#'''''#''#''#''#''#''''''''#'''''''''''#'''''#''#
##############################################''#